32 28 13 13 00FF9900 map2.txt
1,1,1,1,1,1,1,1,1,1,1,1,1,1,1,1,1,1,1,1,1,1,1,1,1,1,1,1
1,3,3,3,3,3,3,3,3,3,3,3,3,1,1,3,3,3,3,3,3,3,3,3,3,3,3,1
1,3,1,1,1,1,3,1,1,1,1,1,3,1,1,3,1,1,1,1,1,3,1,1,1,1,3,1
1,4,1,1,1,1,3,1,1,1,1,1,3,1,1,3,1,1,1,1,1,3,1,1,1,1,4,1
1,3,1,1,1,1,3,1,1,1,1,1,3,1,1,3,1,1,1,1,1,3,1,1,1,1,3,1
1,3,1,1,1,1,3,1,1,1,1,1,3,1,1,3,1,1,1,1,1,3,1,1,1,1,3,1
1,3,3,3,3,3,3,3,3,3,3,3,3,3,3,3,3,3,3,3,3,3,3,3,3,3,3,1
1,3,1,1,1,1,3,1,1,3,1,1,1,1,1,1,1,1,3,1,1,3,1,1,1,1,3,1
1,3,1,1,1,1,3,1,1,3,1,1,1,1,1,1,1,1,3,1,1,3,1,1,1,1,3,1
1,3,3,3,3,3,3,1,1,3,3,3,3,1,1,3,3,3,3,1,1,3,3,3,3,3,3,1
1,1,1,1,1,1,3,1,1,1,1,1,3,1,1,3,1,1,1,1,1,3,1,1,1,1,1,1
1,1,1,1,1,1,3,1,1,1,1,1,3,1,1,3,1,1,1,1,1,3,1,1,1,1,1,1
1,1,1,1,1,1,3,1,1,3,3,3,3,3,3,3,3,3,3,1,1,3,1,1,1,1,1,1
1,1,1,1,1,1,3,1,1,3,1,1,1,2,2,1,1,1,3,1,1,3,1,1,1,1,1,1
1,1,1,1,1,1,3,1,1,3,1,2,2,2,2,2,2,1,3,1,1,3,1,1,1,1,1,1
3,3,3,3,3,3,3,3,3,3,1,2,2,2,2,2,2,1,3,3,3,3,3,3,3,3,3,3
1,1,1,1,1,1,3,1,1,3,1,2,2,2,2,2,2,1,3,1,1,3,1,1,1,1,1,1
1,1,1,1,1,1,3,1,1,3,1,1,1,1,1,1,1,1,3,1,1,3,1,1,1,1,1,1
1,1,1,1,1,1,3,1,1,3,3,3,3,3,3,3,3,3,3,1,1,3,1,1,1,1,1,1
1,1,1,1,1,1,3,1,1,3,1,1,1,1,1,1,1,1,3,1,1,3,1,1,1,1,1,1
1,1,1,1,1,1,3,1,1,3,1,1,1,1,1,1,1,1,3,1,1,3,1,1,1,1,1,1
1,3,3,3,3,3,3,3,3,3,3,3,3,1,1,3,3,3,3,3,3,3,3,3,3,3,3,1
1,3,1,1,1,1,3,1,1,1,1,1,3,1,1,3,1,1,1,1,1,3,1,1,1,1,3,1
1,3,1,1,1,1,3,1,1,1,1,1,3,1,1,3,1,1,1,1,1,3,1,1,1,1,3,1
1,4,3,3,1,1,6,3,3,3,3,3,3,3,3,3,3,3,3,3,3,6,1,1,3,3,4,1
1,1,1,3,1,1,3,1,1,3,1,1,1,1,1,1,1,1,3,1,1,3,1,1,3,1,1,1
1,1,1,3,1,1,3,1,1,3,1,1,1,1,1,1,1,1,3,1,1,3,1,1,3,1,1,1
1,3,3,3,3,3,3,1,1,3,3,3,3,1,1,3,3,3,3,1,1,3,3,3,3,3,3,1
1,3,1,1,1,1,1,1,1,1,1,1,3,1,1,3,1,1,1,1,1,1,1,1,1,1,3,1
1,3,1,1,1,1,1,1,1,1,1,1,3,1,1,3,1,1,1,1,1,1,1,1,1,1,3,1
1,3,3,3,3,3,3,3,3,3,3,3,3,3,3,3,3,3,3,3,3,3,3,3,3,3,3,1
1,1,1,1,1,1,1,1,1,1,1,1,1,1,1,1,1,1,1,1,1,1,1,1,1,1,1,1
